NO ./files/textures/11.xpm
WE ./files/textures/22.xpm

R 800 600

S ./files/textures/chevalier.xpm
SO ./files/textures/test3.XPM


EA ./files/textures/test.xpm

C 211,93,34
F 68,40,25

11111111 11111111111111111111111
11000001110000002000001111111111   
10010000000000000000000011111111
111111111111111001110000000000001
1001           100000110000111011111111111
11111111111111100000010001111111
1 111011111111001010100100011111
11000000110101011000000100011111
10002000000000011000000100011111
1000000000000011100010011111111                        111
11000001110101011101111001111111
1101011111101011110000000000000W1    1
11111111111111111111111111111111111111111111111111111111111