NO ./files/textures/11.xpm
WE ./files/textures/22.xpm
S  ./files/textures/chevalier.xpm
EA ./files/textures/test.xpm
SO ./files/textures/test3.XPM
R  800 600
F  000,100,0000
C  100,100,100


       111111111   111111111111111    
      1200000021  100000000000000211  
     10000000001  1202021111111000001 
    100001100001  1111111     1000001 
   100001 100001              1000001 
  100001  100001              1000001 
 100001   100001           111100001  
100001111110000111    1111100000011   
120000000000N00021  1120000002111     
111111111100000111 10000011111        
          100001  1000001             
          100001  1000001             
          100001  1000001       111111
        110000001112000021111111000001
        120000000000000000000000000021
        111111111111111111111111111111
